WE ./game/textures/wall3.xpm 
NO ./game/textures/wall.xpm
SO       ./game/textures/wall2.xpm
EA       ./game/textures/wall4.xpm   
F 192,192,192 
C 0,255,255
111111111
100000001
1000000001
1000000001
1000000001
1000000001
1011111101
1000000001
1000000001
1000110001
1000000001
1000000001
1110000111
1001001001
1111100001
1000000001                                    
1001111111
1001000001
1001000001
1001001001
1000001001
1000001001
1111111001
1000001001
1000001001
1000001001
1000001001
1000001001
1000001001
1000001001
1000001001
1000001001
1000001001
1000001001
1000001001
1000001001
10000N1001
1111001001
1000001001
1000000001
1000000001
1000001001
1111001111
1100001001
111100111
1000001001
1000001001
1000000001
1000001001
1000000001
1100000001
1010001001
1001100001
111 11111
11 1
