NO ./textures/wall.xpm
SO ./textures/wall2.xpm
WE ./textures/wall3.xpm
EA ./textures/wall4.xpm

C 0,255,255
F 192,192,192
1111111111
1000000001
1000000001
1000000001
1000000001
1000000001
1011111101
1000000001
1000000001
1000110001
1000000001
1000000001
1110000111
1001001001
1111100001
1000000001
1001111111
1001000001
1001000001
1001001001
1000001001
1000001001
1111111001
1000001001
1000001001
1000001001
1000001001
1000001001
1000001001
1000001001
1000001001
1000001001
1000001001
1000001001
1000001001
1000001001
1000001001
1111001001
1000001001
1000001001
1000001001                       
1000001001
1111111111
1100001001
1111111111
1N00001001
1000001001
1000000001
1000001001
1000000001
1100000001
1010001001
1000010001
1000000001
1111111111

