NO ./textures/wall.xpm
SO ./textures/wall2.xpm
WE ./textures/wall3.xpm
EA ./textures/wall4.xpm

C 0,255,255
F 192,192,192

1111111111
1000000001
1000000001
1000000001
1000000001
10000S0001
1011111101
1000000001
1000000001
1111111111

