NO ./path_to_the_north_texture
SO ./path_to_the_south_texture
WE ./path_to_the_west_texture
EA ./path_to_the_east_texture

C 225,30,0
F 220,100,0

        1111111111111111111
        1000000000110000001
        1011000001110000001
        1001000000000000011
11111111101110000000000001
10011000001110111101111111
111010100111011110N0111
1 1110101 10111101001
1 1111111 111111111111
