NO ./path_to_the_north_texture
SO ./path_to_the_south_texture
WE ./path_to_the_west_texture
EA ./path_to_the_east_texture

C 225,30,0
F 220,100,0

111111111111111111
100001000000000001
100001000000000001
100000000110000001
10000N000001000001
100100001000000001
111111111111111111
