NO ./game/textures/wall.xpm
SO ./game/textures/wall2.xpm
WE ./game/textures/wall3.xpm
EA ./game/textures/wall4.xpm
C 0,255,255
F 192,192,192
1111111111111111111111111111111111111111111111111111111
1000100010000001000010101100100011000000000000010000011
1000100000000000000000100000100010100000000000000000011
1000000000000000000000000100000000000000000000000000001
1000000001000000010000010011000000001000000000000000101
1000100000000000000001000000010000000000000000000000001
1010000000001011000000000000100000000000000100110000001
1010000000000011000010000000000000000000000000000100001
1000001100000000000000001010000000000010000010000000001
1000000000000000000000001000110000000010010000000000001
1000100000001000000010000100000000000000000110100010001
1010000000000000000000000000000100001000100100000001001
1010000000000000000000000001001001000100000000000000001
1000000000101000001100000000000000000000000000000000001
1000000101000010000000000001000000100000000000000001001
1000000000000000000100000000000000000000000010001000001
1000000000100000000000100000000100001000000000000000001
1000000001000000000000000000000000000011000000000001001
1000010000010000000000000000000000000001000100000000001
1100010000000000000000000100000000000011000100000000001
1100000100000000010100000000000010101000100000110000001
1000100000010000000000000000000000000000000000001000001
1100000001000001000001000000001110000000000000001000001
1000000000000010000000000001000000000000000000000000001
1001100010001000001010000100000000000000000000000101001
1000001000000001000000001000000000000000000000000111001
1000001000000011000000000010000000000000001000000100001
1000000000000000000000000000100000101000000000001100001
1000010000000000000000000100000000100000000000000000011
1000000001100010010011001001001000000000000010000000001
1001000100000000000000000000000000000000010100000000001
1100000001000000000000001000000010000000000000000000001
1000010000000001000001001100000000001000101000000000001
1000000010000100000000000001000010000000000100010000011
1110000000000000000000000000000000000001010000000001001
1000010000000100000000000000000000010000000000000000001
1000010000010000000010000000000101000001100000100000001
1000100000000000000000000000000000000000000000100000001
1100000000000001000000000000000000000000001001000000001
1011000000000000101000000010000001000000000000001010001
1000000000000000100000000000000001000000000010000001001
1100010000000000000000000000001100000000000000000000001
1000010101000000001000000000000000000000000000100000001
1100100000000000000100000001100010000100000001000100001
1000000000010001000001000000000001000000000001000100001
1100000000000010000000100000110000010010010100000011101
1000000001000100000000000100010001000000100000000000101
1000001000000010010000000000000000000100000000010000001
1000001000000000010000000000100000000000000000000000101
1001000010000000100010000000100010000000000000011100011
1000000000000000000101010000010000100100010000000000101
1000100000010100000000000100001000000000000011100000001
1000000000000000000000000100000000100000010000000010001
1000001010000000000000000000000000011000000010000000001
1000000000001000000100000000001000000111000000000100001
1000000001000000100000000010000000000000000000000000011
1010000001000000000100010000010000000000011000000001001
1000001000010000001000000000010000010000000000000000101
1100000110010011001000000010010000010000000000000000011
1000100000000001000100000000000000000000001010000000001
1000000000010100100000000001000100000000000000000100001
1000000000000000000000010100010100101001000000000010001
1000100000000100000000000010000000100000000000000000011
1000000000000000000010000011000110011000000000010010001
1000000000000000000000001010000000000010000010000000001
1010010000000010000000000110000010000000010000010000001
1000100000000100000000000000000010000000000000010000101
1000000000010100000000000011010000000000100111000000001
1000000000000000001001000010000000000000000000000000011
1000000000000001000000010000000000000000000001000000111
1001110000000000010000000000000100001000000001001101001
1000000000000000010000010100000000000000000001000000001
1100000010000100000000000000000010001000010000100100001
1000000100000000100000110000000000010010000001000100001
1000001000000000001000010000000010000000000000100010001
1000010001000001000000000110001000000000000000000010101
1000100000110010000001000100000010001000000010000001001
1110000010000001010001101100000000000000010010000001001
1000000001101000000000000001000000000000000000000001001
1000000000000011000000000000000000000100110010010010101
1000000000000000100000101000010001000000000000000000001
1110000000100100100001100000010000010010000000001000001
1010000000000000001001000000000000000000000000000010001
1000000010000000000000000101000000100001000000000000101
1000110001000100000000000000000000000000000000000000101
1001010000000001000000000000110100000000000010010000001
1010010100000101000000000000000110000000000100001010001
1001000000010000000100000010000010100000000000000000001
1000000000000000000000110100000000000000100000010000001
1001000000000000000100000000000000000010010000000100001
1000000010000000001000010001000001001000000010000000001
100010010000000010000000000010000000000N001011000000001
1010011001000000000000001010010000001000000000010100011
1000000000000010000100100000000000001100000000000010001
1010000000100010000000000100001000001000000010000001001
1000000000000000001100100000100000100100001000100000111
1000000000000001000000000010000001000000000000000011001
1010000100000000110001000000000000000110000000000000001
1000001000110010000010000000000001000000110100000000101
1111111111111111111111111111111111111111111111111111111
